XXXXXXXXXXXXXXXXXXXXXXXXXXXXXXXXXXXXXXXXXXXXXXX
X                                       XXXX  X
X   XXXXXXX     XXXXXXX                       X
X   XXXXXXX     XXXXXXX        XXXXXXX        X
X   XXX  XX     XXXXXXX          XXXXX        X
X   XXX  XX     XXXXXXXXX      XXXXXXXXXXX    X
X                                             X
X                                             X
X          XXXXXX                             X
X          XXX  X                             X
X           XXX                XXXXXXX        X
X                              XXXXXXX        X
X                              XXXXXXX        X
X                              XXXXXXX        X
X                              XXXXXXX        X
X                              XXXXXXX        X
X   XXXXXXX                    XXXXXXX        X
X   XXXXXXX  XXXXXXXXXXXX                     X
X   XXXXXXX  XXXXXXXXXXXX                     X
X   XXXXXXX  XXXXXXXXXXXX     XX              X
X             XXXXXXX         XX      XXXX    X
X    XXXXX                XXXXXX        XX    X
X                         XXXXXX      XXXX    X
X           XXXXXXXXXXX     XXXX        XX    X
X    XXX          XXXXX     XXXX              X
X      XXXXX                XXXX              X
XXXXXXXXXXXXXXXXXXXXXXXXXXXXXXXXXXXXXXXXXXXXXXX