XXXXXXXXXXXXXXXXXXXXXXXXXXXXXXXX
X                              X
X   XXXXXXX     XXXXXXX        X
X   XXXXXXX     XXXXXXX        X
X   XXX  XX     XXXXXXX        X
X   XXX  XX     XXXXXXXXX      X
X                              X
X   XXXXXXX                    X
X   XXXXXXX  XXXXXXXXXXXX      X
X   XXXXXXX  XXXXXXXXXXXX      X
X   XXXXXXX  XXXXXXXXXXXX    XXX
X             XXXXXXX        XXX
X    XXXXX               XXXXXXX
X                        XXXXXXX
X           XXXXXXXXXXX    XXXXX
X    XXX          XXXXX    XXXXX
X      XXXXX               XXXXX
XXXXXXXXXXXXXXXXXXXXXXXXXXXXXXXX